abotoar	v.		to button (up)
a agulha	n.		needle
o alfinete	n.		pin
o algodão	n.		cotton
amarelo	adj.		yellow
o anel (-éis)	n.		ring
apertado	adj.		tight(-fitting)
o atacador	n.		(shoe)lace
atar	v.		to tie, to do up, to fasten
atraente	adj.		attractive
azul (-uis)	adj.		blue
o batom (-ns)	n.		lipstick
a blusa	n.		blouse, (woman's) shirt
o boné	n.		cap
o botão (-ões)	n.		button
as botas	n.		boots
branco	adj.		white
o brinco	n.		earring
caber (em)	v.		tofit, to be a good fit
o cachecol (-óis)	n.		scarf
o calçado	n.		footwear
o calção de banho			(pair of) swimming trunks
o calção (-ões)	n.		(pair of) shorts
as calças	n.		trousers
as calças de ganga			jeans
a camisa	n.		shirt
a camisa de dormir			nightdress, nightie
a camisola	n.		sweater, jumper; T-shirt/tee-shirt
a camisola interior			vest
a carteira	n.		wallet; purse
o casaco	n.		coat, jacket
o casaco de pele			fur coat
castanho	adj.		brown
o cetim	n.		satin
o chapéu	n.		hat
os chinelos	n.		slippers
o cinto	n.		belt
cinzento	adj.		grey
o colar	n.		necklace
o colarinho	n.		collar
o colete	n.		waistcoat
colorido	adj.		colourful
comprido	adj.		long
confortável (-eis)	adj.		comfortable
a cor (-es)	n.		colour
de cor viva			brightly coloured
cor-de-laranja	adj.	inv.	orange
cor-de-rosa	adj.	inv.	pink
a correia	n.		strap
coser	v.		to sew
o couro	n.		leather
as cuecas	n.		underpants; knickers
curto	adj.		short
desabotoar	v.		to unbutton
desatar	v.		to untie, to undo, to unfasten
desmazelado	adj.		scruffy, slovenly, unkempt
despir-se	v.		to undress (oneself), to get undressed
dourado	adj.		gold (in colour), golden
elegante	adj.		elegant; stylish, fashionable
encarnado	adj.		red
o fato	n.		(man's) suit
o fato de banho			swimming/bathing costume
o fecho de correr			zip
ficar bem			to look good
fino	adj.		fine, thin, delicate; elegant
folgado	n.		loose(-fitting)
o forro	n.		lining; covering
gastar	v.		to wear out
a gravata	n.		tie
grosseiro	adj.		thick, coarse, rough
o guarda-chuva (-s)	n.		umbrella
o impermeável (-eis)	n.		raincoat
as jóias	n.		jewellery, jewels
a lã	n.		wool
o lenço	n.		handkerchief; (head)scarf
a linha (de coser)	n.		thread
o linho	n.		linen; flax
as luvas	n.		gloves
macio	adj.		soft, smooth
a mancha	n.		stain, mark, spot
a manga	n.		sleeve
a maquilhagem	n.		make-up
a máquina de costura			sewing machine
as meias	n.		stockings
as meias-calças	n.		tights
à moda			fashionable
a moda	n.		fashion
mudar de roupa			to change (one's clothes), to get changed
nu (-a -s -as)	adj.		naked, bare, nude
os óculos	n.		glasses, spectacles
os óculos de sol			sunglasses
de ouro			(made) of gold
a pasta	n.		briefcase
o perfume	n.		perfume
as peúgas	n.		socks
o pijama	n.		(pair of) pyjamas
de prata			(made) of silver, silver
prateado	adj.		silver (in colour), silvery; silver-plated
preto	adj.		black
provar	v.		to try on
a pulseira	n.		bracelet
rasgar	v.		to tear, to rip
o relógio (de pulso)	n.		(wrist)watch
remendar	v.		to mend, to darn; to patch
a roupa	n.		clothes, clothing
a roupa interior			underwear
roxo	adj.		purple
o saco (de mão)	n.		(hand)bag
a saia	n.		skirt
de salto alto			high-heeled
as sandálias	n.		sandals
os sapatos	n.		shoes
a seda	n.		silk
o sobretudo	n.		(over)coat
o soutien	n.		bra
o tamanho	n.		size
o tecido	n.		material, fabric, cloth
os ténis	n.	inv.	trainers
tingir	v.		to dye
a tintura	n.		dye
tirar	v.		to take off, to remove
tricotar	v.		to knit
o uniforme	n.		uniform
o veludo	n.		velvet
verde	adj.		green
o vestido	n.		(woman's) dress
vestir-se	v.		to dress (oneself), to get dressed
o véu	n.		veil

aborrecido	adj.		boring
a aluna	n.		schoolgirl
o aluno	n.		schoolboy
aplicado	adj.		hard-working, industrious
apontar (para)	v.		to point (at/to)
aprender	v.		to learn
aprender de cor			to learn by heart, to memorize
a arte	n.		art
atento	adj.		attentive
o atletismo	n.		athletics
a aula	n.		class, lesson
a aula nocturna			evening class
a biologia	n.		biology
o boletim escolar			(school) report
a borracha	n.		rubber, eraser
o caderno	n.		exercise book, notebook
a calculadora	n.		calculator
o campo de jogos			playing field
a caneta	n.		pen
o certificado	n.		certificate
a ciência	n.		science
complicado	adj.		complicated
comportar-se bem			to behave well, to behave oneself
comportar-se mal			to behave badly, to misbehave
compreender	v.		to understand
o computador (-es)	n.		computer
o conhecimento	n.		knowledge
copiar	v.		to copy
correcto	adj.		correct
criativo	adj.		creative
o curso por correspondência			correspondence course
dar um bom exemplo			to set a good example
dar um mau exemplo			to set a bad example
desatento	adj.		inattentive
desobediente	adj.		disobedient
o dicionário	n.		dictionary
difícil (-eis)	adj.		difficult, hard
o diploma	n.		diploma, (university) degree
o director (-es)	n.		headmaster, (male) headteacher
a directora	n.		headmistress, (female) headteacher
a disciplina	n.		(school) subject; discipline
o ditado	n.		dictation
os dois pontos	n.		colon
dotado	adj.		gifted
a economia	n.		economics
a educação	n.		education
o educação física			physical education, PE
educado	adj.		polite, well-mannered
ensinar	v.		to teach
o ensino	n.		teaching, education
o ensino religioso			religious education, RE
errado	adj.		wrong, mistaken
o erro	n.		mistake, error
a escola	n.		school
escrever	v.		to write
esquecer	v.		to forget
o/a estudante	n.		student
estudar	v.		to study
exacto	adj.		exact; accurate, correct
o exame	n.		exam
o exame de admissão			entrance exam
o exemplo	n.		example
o exercício	n.		exercise
fácil (-eis)	adj.		easy
fazer um exame			to take/sit an exam
fazer uma pergunta			to ask a question
a filosofia	n.		philosophy
a física	n.		physics
formar-se	v.		to graduate
a frase	n.		sentence; phrase
a geografia	n.		geography
o giz	n.		chalk
o graduado	n.		graduate
a gramática	n.		grammar
a história	n.		history
a hora de recreio			break, playtime
a hora do almoço			lunchtime
o horário	n.		timetable
a informática	n.		computer science
instruído	adj.		educated
interessante	adj.		interesting
o jardim de infância			nursery school, kindergarten
o lápis	n.	inv.	pencil
lembrar-se (de)	v.		to remember
ler	v.		to read
a língua estrangeira			foreign language
a literatura	n.		literature
o livro	n.		book
a matemática	n.		mathematics, maths
mostrar	v.		to show, to demonstrate
a música	n.		music
a natação	n.		swimming
a nota	n.		mark, grade
obediente	adj.		obedient
a página	n.		page
o parágrafo	n.		paragraph
passar no exame			to pass the exam
o pátio de recreio			playground
pedir	v.		to ask (for), to request, to demand
a pergunta	n.		question
perguntar	v.		to ask
a pesquisa	n.		research
a política	n.		politics
o ponto de exclamação			exclamation mark
o ponto de interrogação			question mark
o ponto e vírgula			semicolon
o ponto (final)	n.		full-stop
a pontuação	n.		punctuation
a prática	n.		practice
preciso	adj.		precise
preguiçoso	adj.		lazy
o professor (-a -es -as)	n.		teacher, lecturer
o programa de estudos			curriculum, syllabus
a psicologia	n.		psychology
o quadro negro			blackboard
a química	n.		chemistry
a régua	n.		ruler
repetir	v.		to repeat
repetitivo	adj.		repetitive
responder a uma pergunta			to answer a question
a resposta	n.		answer, reply
o resultado	n.		result
saber	v.		to know
a sala de aula			classroom, class
simples	adj.	inv.	simple
a sociologia	n.		sociology
a solução (-ões)	n.		solution, answer
sublinhar	v.		to underline; to emphasize, to stress
a teologia	n.		theology
ter razão			to be right
tirar um curso			to take/do a course
o trabalho de casa			homework
o uniforme	n.		uniform
a universidade	n.		university
a vírgula	n.		comma

o açúcar	n.		sugar
adoçar	v.		to sweeten
o aipo	n.		celery
a alface	n.		lettuce
o alho	n.		garlic
o alho-porro (alhos-porros)	n.		leek
almoçar	v.		to (have) lunch
o almoço	n.		lunch
amargo	adj.		bitter
a ameixa	n.		plum
a amora (silvestre)	n.		blackberry
o ananás (ananases)	n.		pineapple
aromático	adj.		aromatic; fragrant
o arroz	n.		rice
assar	v.		to roast
azedo	adj.		sour
o bacon	n.		bacon
a banana	n.		banana
a batata	n.		potato
a bebida	n.		drink
a beterraba	n.		beetroot
o bife	n.		(beef)steak
o biscoito	n.		biscuit
o bolo	n.		cake
o borrego	n.		lamb
os brócolos	n.		broccoli
a caçarola	n.		(sauce)pan
o café	n.		coffee
a carne	n.		meat
a carne de porco			pork
a carne de vaca			beef
a cebola	n.		onion
a cenoura	n.		carrot
a cereja	n.		cherry
a cerveja	n.		beer
o chá	n.		tea
a chávena	n.		cup
cheirar bem			to smell good/nice
o chocolate	n.		chocolate
a cidra	n.		cider
o cogumelo	n.		mushroom
a colher de chá			teaspoon
a colher (-es)	n.		spoon
a comida	n.		food; meal
congelado	adj.		frozen
a conta	n.		bill
o copo	n.		glass, tumbler
a couve-flor (couves-flores)	n.		cauliflower
cozinhar	v.		to cook
o creme	n.		cream
cru	adj.		raw
o damasco	n.		apricot
delicioso	adj.		delicious
doce	adj.		sweet
a ementa	n.		menu
encomendar	v.		to order
a entrada	n.		starter, first course
a ervilha	n.		pea
os espargos	n.		asparagus
os espinafres	n.		spinach
a faca	n.		knife
a farinha	n.		flour
o feijão (-ões)	n.		bean(s)
ferver	v.		to boil, to simmer
o fiambre	n.		(cooked) ham
a framboesa	n.		raspberry
o frango	n.		chicken
fresco	adj.		fresh; cool
a frigideira	n.		frying pan
frio	adj.		cold
fritar	v.		to fry
a fruta	n.		fruit
o garfo	n.		fork
a geleia	n.		jam
a gordura	n.		fat; grease
grelhar	v.		to grill
a groselha negra			blackcurrant
o jantar	n.		dinner, supper
jantar	v.		to have dinner/supper
a laranja	n.		orange
a lata	n.		tin, can
lavar a louça			to wash up, to do the washing-up
os legumes	n.		vegetables
o leite	n.		milk
o limão (-ões)	n.		lemon
a limonada	n.		lemonade
a maçã	n.		apple
a manteiga	n.		butter
o marisco	n.		shellfish
o mel	n.		honey
a melancia	n.		watermelon
o melão (-ões)	n.		melon
o milho	n.		maize, sweet corn
o molho	n.		sauce; dressing
o morango	n.		strawberry
a mostarda	n.		mustard
a noz	n.		walnut; nut
o óleo	n.		oil
o ovo	n.		egg
o pão (pães)	n.		bread
a passa	n.		raisin
o peixe	n.		fish
o pepino	n.		cucumber
o pequeno-almoço (pequenos-almoços)	n.		breakfast
a pêra	n.		pear
o pêssego	n.		peach
picante	adj.		spicy
a pimenta	n.		pepper (spice)
o pimento	n.		pepper (vegetable)
o pires	n.	inv.	saucer
podre	adj.		rotten
pôr a mesa			to set/lay the table
o pote	n.		pot, jar
o prato	n.		plate, dish; course
o prato principal			main course
provar	v.		to try, to taste
o queijo	n.		cheese
quente	adj.		hot, warm
a refeição (-ões)	n.		meal
o repolho	n.		cabbage
saboroso	adj.		tasty
o sal	n.		salt
a salada	n.		salad
salgado	adj.		salty
a salsa	n.		parsley
a salsicha	n.		sausage
a sandes	n.	inv.	sandwich
a sobremesa	n.		dessert
a sopa	n.		soup
o sumo	n.		juice
os talheres	n.		cutlery
o tempero	n.		seasoning
a tigela	n.		bowl
tirar a mesa			to clear the table
o tomate	n.		tomato
o trigo	n.		wheat
a uva	n.		grape
o vinagre	n.		vinegar
o vinho	n.		wine

o acidente	n.		accident
a alergia	n.		allergy
a ambulância	n.		ambulance
a anca	n.		hip
o antibiótico	n.		antibiotic
a asma	n.		asthma
o ataque cardíaco			heart attack
a barriga	n.		belly, tummy
a bexiga	n.		bladder
o bigode	n.		moustache
a boca	n.		mouth
a bolha	n.		blister
o braço	n.		arm
a bronquite	n.		bronchitis
a cabeça	n.		head
o cabelo	n.		hair
a cadeira de rodas			wheelchair
o calcanhar	n.		heel
o cancro	n.		cancer
cego	adj.		blind
o cérebro	n.		brain
chorar	v.		to cry, to weep
a cicatriz	n.		scar
a cintura	n.		waist
a cirurgia	n.		surgery
o comprimido	n.		tablet, pill
constipar-se	v.		to catch/get a cold
o coração (-ões)	n.		heart
o corpo	n.		body
as costas	n.		back
o cotovelo	n.		elbow
a coxa	n.		thigh
o crânio	n.		skull
a cura	n.		cure
curar	v.		to cure
o dedo	n.		finger
o dedo do pé			toe
deixar de fumar			to give up smoking, to stop/quit smoking
o dente	n.		tooth
descansar	v.		to rest
desmaiar	v.		to faint
o diagnóstico	n.		diagnosis
a doença	n.		illness, disease
doente	adj.		ill, sick
o/a doente	n.		patient
doer	v.		to hurt, to ache
doloroso	adj.		painful
a dor de cabeça			headache
a dor de dentes			toothache
a dor de garganta			sore throat
a dor (-es)	n.		pain, ache
a dor nas costas			backache
dorido	adj.		sore
a dose	n.		dose
a droga	n.		drug
o efeito colateral			side effect
a epidemia	n.		epidemic
a espinha dorsal			spine, backbone
o esqueleto	n.		skeleton
o estômago	n.		stomach
fazer exercício			to (take) exercise, to do/get some exercise
ferido	adj.		injured; wounded
o fígado	n.		liver
forte	adj.		strong
fraco	adj.		weak
o furúnculo	n.		boil
a garganta	n.		throat
grávida	adj.		pregnant
a gripe	n.		flu, influenza
infeccioso	adj.		infectious
a injecção (-ões)	n.		injection
a insolação (-ões)	n.		sunstroke
o joelho	n.		knee
o lábio	n.		lip
a ligadura	n.		bandage
a língua	n.		tongue
manter-se em forma			to keep fit
a mão (-s)	n.		hand
o maxilar (-es)	n.		jaw
o medicamento	n.		medicine
morrer	v.		to die
a muleta	n.		crutch
o músculo	n.		muscle
o nariz	n.		nose
a nutrição	n.		nutrition
o olho	n.		eye
o ombro	n.		shoulder
a operação (-ões)	n.		operation
a orelha	n.		ear
o osso	n.		bone
pálido	adj.		pale
a pálpebra	n.		eyelid
partir a perna			to break one's leg
o pé	n.		foot
o peito	n.		chest, breast
a pele	n.		skin
o penso (rápido)	n.		(sticking) plaster
a perna	n.		leg
o pescoço	n.		neck
a pestana	n.		eyelash
a pílula contraceptiva			contraceptive pill
o polegar (-es)	n.		thumb
o preservativo	n.		condom
a prisão de ventre			constipation
o pulmão (-ões)	n.		lung
o pulso	n.		wrist; pulse
o queixo	n.		chin
a receita	n.		prescription
recuperar-se	v.		to recuperate, to recover
respirar	v.		to breathe
o rim (-ns)	n.		kidney
rouco	adj.		hoarse
sangrar	v.		to bleed
o sangue	n.		blood
saudável (-veis)	adj.		healthy
a saúde	n.		health
o seio	n.		(woman's) breast
sentir-se mal			to feel ill
a seringa	n.		syringe
a sobrancelha	n.		eyebrow
sofrer (de)	v.		to suffer (from)
o suor (-es)	n.		sweat
surdo	adj.		deaf
a tensão arterial			blood pressure
o termómetro	n.		thermometer
a testa	n.		forehead
o tornozelo	n.		ankle
tossir	v.		to cough
o tratamento	n.		treatment
o tumor (-es)	n.		tumour
a úlcera	n.		ulcer
a unha	n.		(finger/toe)nail
a vacinação (-ões)	n.		vaccination
o veneno	n.		poison; venom
a virilha	n.		groin
viver	v.		to live
vomitar	v.		to throw up, to be sick, to vomit

abrir	v.		to open
acordar	v.		to wake up
adormecer	v.		to fall asleep; to go to sleep
a alcatifa	n.		carpet
a almofada	n.		pillow
o andar	n.		floor, storey
antigo	adj.		old; antique; old-fashioned
o apartamento	n.		flat
o aquecedor (-es)	n.		heater
o aquecimento	n.		heating
o armário	n.		cupboard
arrumar	v.		to tidy (up)
o aspirador (-es)	n.		vacuum cleaner, hoover
aspirar	v.		to vacuum, to hoover
em baixo			downstairs; below
o balde	n.		bucket
a banheira	n.		bath(tub)
barbear-se	v.		to (have a) shave
a cadeira	n.		chair
o caixote de lixo			(rubbish) bin, dustbin
a cama	n.		bed
o capacho	n.		doormat
em casa			at home
a casa	n.		house
a casa de banho	n.		bathroom
a cera	n.		wax
a chaleira	n.		kettle
a chaminé	n.		chimney
o chão	n.		floor, ground
a chave	n.		key
em cima			upstairs; above
claro	adj.		light, bright; clear
o cobertor (-es)	n.		blanket
o colchão (-ões)	n.		mattress
a cómoda	n.		chest of drawers
confortável (-eis)	adj.		comfortable
o congelador (-es)	n.		freezer
construir	v.		to build, to construct
a cortina	n.		curtain
a cozinha	n.		kitchen; cooking, cookery
deitar-se	v.		to lie down; to go to bed
dentro de casa			inside, indoors
desarrumado	adj.		untidy
o despertador (-es)	n.		alarm clock
dormir	v.		to sleep
o duche	n.		shower
eléctrico	adj.		electric
as escadas	n.		stairs
a escova	n.		brush
a escova de dentes			toothbrush
escovar os dentes			to brush one's teeth
o escritório	n.		study; office
escuro	adj.		dark
espaçoso	adj.		spacious
o espelho	n.		mirror
a estante	n.		bookcase
estender a roupa			to hang out/up the washing/laundry
fazer a cama			to make the bed
a fechadura	n.		lock
fechar	v.		to close, to shut
fechar à chave			to lock
o ferro de engomar	n.		iron
o fogão (-ões)	n.		stove, cooker
fora de casa			outside, outdoors
o forno	n.		oven
o forno de microondas			microwave (oven)
o frigorífico	n.		refrigerator, fridge
a garagem	n.		garage
a gaveta	n.		drawer
o guarda-fato (-s)	n.		wardrobe
húmido	adj.		damp; humid
a janela	n.		window
o jardim	n.		garden
a lareira	n.		hearth, fireplace
o lava-louça (-s)	n.		(kitchen) sink
lavar a roupa			to do the washing/laundry
lavar-se	v.		to (have a) wash, to wash oneself
o lavatório	n.		(wash)basin, (bathroom) sink
o lençol (-óis)	n.		sheet
limpar	v.		to clean; to wipe
limpo	adj.		clean
a máquina de lavar louça			dishwasher
a máquina de lavar roupa			washing machine
a mesa	n.		table
a mobília	n.		furniture
moderno	adj.		modern
molhado	adj.		wet
o muro	n.		(garden) wall
o pano	n.		cloth
o papel de parede			wallpaper
a parede	n.		wall
passar a ferro			to iron
a pasta de dentes			toothpaste
o pente	n.		comb
pentear-se	v.		to comb one's hair
a persiana	n.		(venetian) blind
pintar	v.		to paint
polir	v.		to polish
a poltrona	n.		armchair
a porta	n.		door
o portão (-ões)	n.		gate
a prateleira	n.		shelf
o quadro	n.		picture, painting
o quarto	n.		room
o quarto (de dormir)	n.		bedroom
o rádio	n.		radio
o relvado	n.		lawn
reparar	v.		to repair
o rés-do-chão	n.		ground floor
o sabão	n.		soap
a sala de estar			living/sitting room
a sala de jantar			dining room
seco	adj.		dry
a secretária	n.		desk
seguro	adj.		safe, secure
sentar-se	v.		to sit down
o sofá	n.		sofa
o sótão (-s)	n.		attic, loft
sujo	adj.		dirty
o tapete	n.		rug, mat
o tecto	n.		ceiling
o telefone	n.		telephone
a televisão (-ões)	n.		television
o telhado	n.		roof
a tesoura	n.		(pair of) scissors
a toalha	n.		towel
tomar banho			to have/take a bath
tomar um duche			to have/take a shower
o toucador (-es)	n.		dressing table
varrer	v.		to sweep
o vaso	n.		(plant) pot; vase
a vassoura	n.		broom
a vedação (-ões)	n.		fence
o vizinho	n.		neighbour

a actividade	n.		activity
agradável (-eis)	adj.		pleasant
aplaudir	v.		to applaud, to clap
o árbitro	n.		referee; umpire
a arte	n.		art
o ás de espadas			ace of spades
assustador (-a -es -as)	adj.		frightening
o atletismo	n.		athletics
a audiência	n.		audience
o automobilismo	n.		motor racing
o bailado	n.		ballet
o baralho	n.		pack/deck of cards
o basquetebol	n.		basketball
a bateria	n.		drums, drum kit
o bilhar	n.		billiards
a bola	n.		ball
o boxe	n.		boxing
o campeonato	n.		championship
o canal (de televisão)	n.		(television) channel
a canção (-ões)	n.		song
cansativo	adj.		tiring
cantar	v.		to sing
o capítulo	n.		chapter; episode
o cinema	n.		cinema
o clarinete	n.		clarinet
a comédia	n.		comedy
comovente	adj.		moving
a competição (-ões)	n.		competition, contest
o concerto	n.		concert
a corrida de cavalos			horse-racing
o críquete	n.		cricket
a crítica	n.		review, write-up
a dama de copas			queen of hearts
dançar	v.		to dance
desagradável (-eis)	adj.		unpleasant
desapontar	v.		to disappoint
o desempenho	n.		performance
desenhar	v.		to draw
o desenho	n.		drawing
o desenho animado			(animated) cartoon
o desporto	n.		sport
divertido	adj.		amusing, entertaining, fun
o divertimento	n.		amusement, fun
divertir-se	v.		to amuse/enjoy oneself, to have fun
o documentário	n.		documentary
o empate	n.		draw, tie
engraçado	adj.		funny, amusing
o ensaio geral			dress rehearsal
a equipa	n.		team
o esboço	n.		sketch; draft; outline
a escultura	n.		sculpture
o espectáculo	n.		show; spectacle
o espectador (-a -es -as)	n.		spectator; viewer
o esqui	n.		skiing; ski
esquiar	v.		to ski
excelente	adj.		excellent
excitante	adj.		exciting
a exposição (-ões)	n.		exhibition
o/a fã	n.		fan, supporter
favorito	adj.		favourite
a ficção científica			science fiction
a ficção (-ões)	n.		fiction
o filme	n.		film, movie
o filme de terror			horror film
a flauta	n.		flute
o futebol	n.		football
ganhar	v.		to win; to earn
a ginástica	n.		gymnastics
o golfe	n.		golf
a guitarra	n.		guitar
a história	n.		story; history
improvisar	v.		to improvise
o instrumento de sopro			wind instrument
interessante	adj.		interesting
interessar-se (em/por)	v.		to be interested (in)
o intervalo	n.		interval
o jazz	n.		jazz
jogar futebol			to play football
jogar xadrez			to play chess
o jogo	n.		game
o jogo de cartas			card game
o jogo de computador			computer game
o jornal (-ais)	n.		newspaper
a literatura	n.		literature
o livro	n.		book
a máquina fotográfica			camera
marcar um golo			to score a goal
o meio-tempo	n.		half-time
o montanhismo	n.		mountaineering, climbing
a música	n.		music
a música clássica			classical music
a música pop			pop music
nadar	v.		to swim
a natação	n.		swimming
as notícias	n.		news
o oboé	n.		oboe
a ópera	n.		opera
a orquestra	n.		orchestra
as palavras cruzadas			crossword
o palco	n.		stage
a partida	n.		match, game
o passatempo	n.		pastime, hobby
a patinagem (no gelo)	n.		(ice-)skating
patinar	v.		to skate
a peça	n.		(stage) play
perder	v.		to lose
o piano	n.		piano
o piano de cauda			grand piano
o pincel (-éis)	n.		(paint)brush
pintar	v.		to paint
a pintura	n.		painting
o poema	n.		poem
a poesia	n.		poetry
popular	adj.		popular
preferir	v.		to prefer
o programa (de televisão)	n.		(television) programme
a raqueta (de ténis)	n.		(tennis) racket/racquet
o rei de paus			king of clubs
representar	v.		to perform; to play (a part/role)
o retrato	n.		portrait
a revista	n.		magazine
o romance	n.		novel; romance
o romance policial	n.		detective story, crime novel
o saxofone	n.		saxophone
sentimental (-ais)	adj.		sentimental
o tambor (-es)	n.		drum
o tempo livre			free/spare time
o ténis	n.	inv.	tennis
o ténis de mesa			table tennis
o título	n.		title
tocar guitarra			to play the guitar
tocar piano			to play the piano
a tragédia	n.		tragedy
o trombone	n.		trombone
o valete de ouros			jack of diamonds
velejar	v.		to sail
ver televisão			to watch television
o violino	n.		violin
o violoncelo	n.		cello
o xadrez	n.		chess


abafado	adj.		close, sultry, humid
a abelha	n.		bee
acasalar-se (com)	v.		to mate (with)
a água	n.		water
a águia	n.		eagle
o animal (-ais)	n.		animal
apodrecer	v.		to rot
o ar	n.		air
a aranha	n.		spider
o arbusto	n.		bush, shrub
o arco-íris	n.	inv.	rainbow
a areia	n.		sand
a árvore	n.		tree
a atmosfera	n.		atmosphere
a avalanche	n.		avalanche
a baía	n.		bay
a barata	n.		cockroach
a borboleta	n.		butterfly
o bosque	n.		wood(s)
a brisa	n.		breeze
o burro	n.		donkey
o campo	n.		field; country(side)
o cão (cães)	n.		dog
o caracol (-óis)	n.		snail
o caule	n.		stem, stalk
o cavalo	n.		horse
o céu	n.		sky
chover	v.		to rain
a chuva	n.		rain
a chuvada	n.		shower, downpour
o chuvisco	n.		drizzle
a cobra	n.		snake
o coelho	n.		rabbit
a colina	n.		hill
a constelação (-ões)	n.		constellation
o continente	n.		continent
a coruja	n.		owl
a costa	n.		coast
crescer	v.		to grow
o crocodilo	n.		crocodile
o deserto	n.		desert
o elefante	n.		elephant
o espinho	n.		thorn
a estrela	n.		star
fértil (-eis)	adj.		fertile
a flor (-es)	n.		flower
florescer	v.		to flower, to bloom, to blossom
a floresta	n.		forest
o fogo	n.		fire
a folha	n.		leaf
a formiga	n.		ant
o furacão	n.		hurricane
a galáxia	n.		galaxy
a galinha	n.		hen, chicken
o galo	n.		cock
o gato	n.		cat
o gelo	n.		ice
a ilha	n.		island
íngreme	adj.		steep
o insecto	n.		insect
o lago	n.		lake
o leão (-ões)	n.		lion
a lesma	n.		slug
o lobo	n.		wolf
a lua	n.		moon
o mar	n.		sea
a maré	n.		tide
a margem	n.		(river)bank
a montanha	n.		mountain
o morcego	n.		bat
morto	adj.		dead
o mosquito	n.		mosquito
o mundo	n.		world
natural (-ais)	adj.		natural
nevar	v.		to snow
a neve	n.		snow
o nevoeiro	n.		fog
nublado	adj.		cloudy, overcast
a nuvem	n.		cloud
o oceano	n.		ocean
a onda	n.		wave
a ovelha	n.		sheep
o pântano	n.		marsh, bog, swamp
o pássaro	n.		bird
a pastagem	n.		pasture
a pedra	n.		stone
pegar fogo			to catch fire
o peixe	n.		fish
o penhasco	n.		cliff
a península	n.		peninsula
o planeta	n.		planet
a planta	n.		plant
o porco	n.		pig
o prado	n.		meadow
a praia	n.		beach
profundo	adj.		deep
queimar	v.		to burn
a raiz	n.		root
o ramo	n.		branch
a raposa	n.		fox, vixen
o rato	n.		mouse
o relâmpago	n.		lightning
reproduzir-se	v.		to reproduce, to multiply, to breed
o ribeiro	n.		stream, brook
o rio	n.		river
a rocha	n.		rock
a saraiva	n.		hail
a selva	n.		jungle
a semente	n.		seed
a sistema solar			solar system
o sol	n.		sun
a tempestade	n.		storm
o tempo	n.		weather; time
a terra	n.		earth, land, ground
o terramoto	n.		earthquake
o tigre	n.		tiger
o tronco	n.		(tree) trunk
o trovão	n.		(clap of) thunder
a trovoada	n.		thunderstorm
o universo	n.		universe
o urso	n.		bear
a vaca	n.		cow
o vale	n.		valley
a vegetação	n.		vegetation
o vento	n.		wind
o verme	n.		worm
a vespa	n.		wasp
vivo	adj.		alive, living
o vulcão (-ões)	n.		volcano


acolher	v.		to welcome
o actor (-es)	n.		actor
a actriz (-es)	n.		actress
admirar	v.		to admire
a adolescência	n.		adolescence
o/a adolescente	n.		adolescent
o adulto	n.		(male) adult
o advogado	n.		(male) lawyer
agressivo	adj.		aggressive
amar	v.		to love
ambicioso	adj.		ambitious
amigável (-eis)	adj.		friendly, amicable
o amigo	n.		(male) friend
o antepassado	n.		(male) ancestor
o apelido	n.		surname, last name
o arquitecto	n.		(male) architect
arrogante	adj.		arrogant
o/a artista	n.		artist
atraente	adj.		attractive
o autor (-a -es -as)	n.		author
a avó	n.		grandmother
o avô	n.		grandfather
os avós	n.		grandparents
o bailarino	n.		(male) dancer
o bebé	n.		baby
belo	adj.		beautiful
o bibliotecário	n.		(male) librarian
o bombeiro	n.		fireman
o cabeleireiro	n.		(male) hairdresser
o/a camionista	n.		lorry driver
o canalizador (-a -es -as)	n.		plumber
o cantor (-a -es -as)	n.		singer
o carteiro	n.		postman
casado	adj.		married
o casamento	n.		marriage, wedding
casar-se (com)	v.		to marry, to get married (to)
o/a cientista	n.		scientist
o cirurgião (-ã -ões -ãs)	n.		surgeon
ciumento	adj.		jealous
o compositor (-a -es -as)	n.		composer
conhecer	v.		to know; to meet, to get to know
o construtor (-a -es -as)	n.		builder
o/a contabilista	n.		accountant
o cozinheiro	n.		(male) cook/chef
a criada (de mesa)	n.		waitress
o criado (de mesa)	n.		waiter
a criança	n.		child
cruel (-éis)	adj.		cruel
a cunhada	n.		sister-in-law
o cunhado	n.		brother-in-law
a data de nascimento			date of birth
o/a dentista	n.		dentist
deprimido	adj.		depressed
desprezar	v.		to despise
o/a diplomata	n.		diplomat
divorciado	adj.		divorced
egoísta	adj.		selfish
o/a electricista	n.		electrician
elogiar	v.		to praise; to compliment
a enfermeira	n.		(female) nurse
o engenheiro	n.		(male) engineer
a enteada	n.		stepdaughter
o enteado	n.		stepson
o escritor (-a -es -as)	n.		writer
esperto	adj.		clever
estúpido	adj.		stupid; rude, coarse
a família	n.		family
famoso	adj.		famous
feio	adj.		ugly
feliz (-es)	adj.		happy
a filha	n.		daughter
o filho	n.		son
o fotógrafo	n.		(male) photographer
franco	adj.		frank
o funcionário (público)	n.		(male) civil servant
o gémeo	n.		(male) twin
generoso	adj.		generous
o genro	n.		son-in-law
gentil (-is)	adj.		kind
gostar (de)	v.		to like
o homem	n.		man
o homem de negócios			businessman
honesto	adj.		honest
a idade	n.		age
impiedoso	adj.		merciless, ruthless, pitiless
a infância	n.		childhood, infancy
insultar	v.		to insult
inteligente	adj.		intelligent
invejar	v.		to envy; to be envious
invejoso	adj.		envious
a irmã	n.		sister
o irmão	n.		brother
o jardineiro	n.		(male) gardener
o/a jornalista	n.		journalist
o juiz (-íza -ízes -ízas)	n.		judge
o lavrador (-a -es -as)	n.		farmer
lisonjear	v.		to flatter
a madrasta	n.		stepmother
a mãe	n.		mother
o/a maquinista	n.		train/engine driver
o marido	n.		husband
o marinheiro	n.		(male) sailor
o matrimónio	n.		marriage, matrimony
o mecânico	n.		(male) mechanic
o médico	n.		(male) doctor
o mineiro	n.		(male) miner
modesto	adj.		modest
a morada	n.		address
morrer	v.		to die
a morte	n.		death
o/a motorista de autocarro			bus driver
a mulher	n.		woman; wife
o músico	n.		(male) musician
a namorada	n.		girlfriend
o namorado	n.		boyfriend
nascer	v.		to be born
o nascimento	n.		birth
a neta	n.		granddaughter
o neto	n.		grandson
os netos	n.		grandchildren
a noiva	n.		fiancée; bride
noivo	adj.		engaged (to be married)
o noivo	n.		fiancé; groom
o nome	n.		name
a nora	n.		daughter-in-law
o número de telefone			telephone number
a ocupação (-ões)	n.		occupation
odiar	v.		to hate
orgulhoso	adj.		proud
o padrasto	n.		stepfather
o pai	n.		father
os pais	n.		parents
o/a parente	n.		relative, relation
partilhar	v.		to share
perdoar	v.		to forgive, to pardon
o pescador (-a -es -as)	n.		fisherman
a pessoa	n.		person
o piloto	n.		pilot
o pintor (-a -es -as)	n.		painter
pobre	adj.		poor
o/a polícia	n.		police officer
preguiçoso	adj.		lazy
o primo	n.		(male) cousin
a profissão (-ões)	n.		profession
a rapariga	n.		girl, young woman
o rapaz	n.		boy, young man
reconhecer	v.		to recognize
rico	adj.		rich
a secretária	n.		(female) secretary
simpático	adj.		nice, pleasant, friendly
a sobrinha	n.		niece
o sobrinho	n.		nephew
a sogra	n.		mother-in-law
o sogro	n.		father-in-law
o soldado	n.		soldier
o/a taxista	n.		taxi driver
a tia	n.		aunt
tímido	adj.		shy, timid
o tio	n.		uncle
triste	adj.		sad
velho	adj.		old
a vida	n.		life


aceitar	v.		to accept
acusar (de)	v.		to accuse (of); to charge (with)
alistar-se no exército			to join the army
a arma	n.		weapon
o assalto	n.		robbery, burglary; assault, mugging
assassinar	v.		to murder; to assassinate
atacar	v.		to attack
o ataque	n.		attack
a bomba	n.		bomb
o/a budista	n.		Buddhist
o capitalismo	n.		capitalism
a cerimónia	n.		ceremony
a chantagem	n.		blackmail
chegar ao poder			to come to power, to gain power
chocante	adj.		shocking
civilizado	adj.		civilized
o comércio	n.		trade, commerce; business
a comunidade	n.		community
o comunismo	n.		communism
concordar	v.		to agree
condenar (a)	v.		to condemn (to), to sentence (to)
confessar-se culpado			to plead guilty
conformar-se (com)	v.		to conform (to)
a conquista	n.		conquest
contemporâneo	adj.		contemporary
o contrato	n.		contract
controverso	adj.		controversial
a corrupção (-ões)	n.		corruption
o crime	n.		crime, criminal act
a criminalidade	n.		crime, criminality
o criminoso	n.		(male) criminal
o cristão (-ã -ãos -ãs)	n.		Christian
o cristianismo	n.		Christianity
culpado	adj.		guilty
a cultura	n.		culture
declarar guerra (a)			to declare war (on)
o delito	n.		(minor) crime, offence
a democracia	n.		democracy
derrotar	v.		to defeat
o desemprego	n.		unemployment
despedir	v.		to dismiss, to sack, to fire
devoto	adj.		devout
discutir	v.		to discuss; to argue
discutível (-eis)	adj.		debatable, arguable
a ditadura	n.		dictatorship
a dívida	n.		debt
a economia	n.		economy
económico	adj.		economic
eficiente	adj.		efficient
eleger	v.		to elect
a eleição (-ões)	n.		election
a embaixada	n.		embassy
entrar em greve			to (go on) strike
a escravatura	n.		slavery
espancar	v.		to beat up
a espingarda	n.		rifle, shotgun
o exército	n.		army
a fábrica	n.		factory
a falência	n.		bankruptcy
a força aérea			air force
a fraude	n.		fraud
governar	v.		to govern, to rule
o governo	n.		government
a greve	n.		strike, walkout
a guerra	n.		war
o/a hindu	n.		Hindu
o hinduísmo	n.		Hinduism
ilegal (-ais)	adj.		illegal
imparcial (-ais)	adj.		impartial
importante	adj.		important
a independência	n.		independence
a indústria	n.		industry
a inflação	n.		inflation
injusto	adj.		unjust, unfair
inocente	adj.		innocent
internacional (-ais)	adj.		international
interrogar	v.		to interrogate, to question
invadir	v.		to invade
a invasão (-ões)	n.		invasion
o investimento	n.		investment
o Islão	n.		Islam
o judaísmo	n.		Judaism
o judeu (-ia -eus -ias)	n.		Jew
o júri	n.		jury
a justiça	n.		justice; fairness
justo	adj.		just, fair
legal (-ais)	adj.		legal
a lei	n.		law
a liberdade	n.		freedom, liberty
o lucro	n.		profit
lutar (contra)	v.		to fight (against)
a maioria	n.		majority
a manifestação (-ões)	n.		demonstration, protest
a marinha (de guerra)	n.		navy
matar	v.		to kill
a metralhadora	n.		machine gun
a minoria	n.		minority
moderno	adj.		modern
a monarquia	n.		monarchy
o muçulmano	n.		Moslem/Muslim
nacional (-ais)	adj.		national
a nacionalidade	n.		nationality
a opressão (-ões)	n.		oppression
a oração (-ões)	n.		prayer
o partido (político)	n.		(political) party
a paz	n.		peace
a pena de morte			death penalty, capital punishment
perigoso	adj.		dangerous
a pesquisa de opinião			opinion poll
a pistola	n.		pistol
poderoso	adj.		powerful
a polícia	n.		police (force)
a política	n.		politics; policy
político	adj.		political
a população (-ões)	n.		population
o/a presidente	n.		president
o prisioneiro	n.		prisoner
privado	adj.		private
o processo	n.		trial
proibir	v.		to ban, to prohibit; to forbid
protestar	v.		to protest
público	adj.		public
a punição (-ões)	n.		punishment
punir	v.		to punish
a rainha	n.		queen
rebelar-se (contra)	v.		to rebel (against)
recusar-se (a)	v.		to refuse (to)
o rei	n.		king
a religião (-ões)	n.		religion
render-se (a)	v.		to surrender (to)
o/a representante	n.		representative
a responsabilidade	n.		responsibility
rezar	v.		to pray
roubar	v.		to steal; to rob
o roubo	n.		theft, robbery
sagrado	adj.		sacred, holy
seguro	adj.		safe, secure
a sentença de morte	n.		death sentence
o sindicato	n.		trade union
a sociedade	n.		society
subornar	v.		to bribe
o suborno	n.		bribe
suicidar-se	v.		to commit suicide
o suicídio	n.		suicide
ter lucro			to make a profit
terrível (-eis)	adj.		terrible
o terrorismo	n.		terrorism
a testemunha ocular			eye witness
torturar	v.		to torture
a tradição (-ões)	n.		tradition
a traição (-ões)	n.		betrayal; treason
o traidor (-a -es -as)	n.		traitor
o vandalismo	n.		vandalism
a violação (-ões)	n.		rape; violation
violar	v.		to rape; to violate
a vitória	n.		victory
votar (em)	v.		to vote (for)

achar	v.		to find
o andar	n.		floor, storey
o arco	n.		arch
o assento	n.		seat
atravessar a rua			to cross the road
o banco	n.		bank; bench
o bar	n.		bar
barato	adj.		cheap, inexpensive
a barbearia	n.		barber's (shop)
o beco sem saída			dead end, cul-de-sac
a biblioteca	n.		library
de boa/alta qualidade			(of) good/high quality
o cabeleireiro	n.		hairdresser's, hair(dressing) salon
a cabine telefónica			telephone box/booth
a caixa	n.		box; checkout, cash desk
o caixa automático			cash machine/dispenser
a caixa registadora	n.		cash register, till
a câmara municipal			town hall
cansar-se	v.		to get/grow tired
o canteiro de obras			building site
caro	adj.		dear, expensive
o cartão de crédito	n.		credit card
a catedral	n.		cathedral
o cesto	n.		basket
o cheque	n.		cheque
o cinema	n.		cinema
o circo	n.		circus
o/a cliente	n.		customer, client
comprar	v.		to buy
contar	v.		to count
os correios	n.		post office
o cruzamento	n.		crossroads
custar	v.		to cost
dar um passeio			to go for a walk
o desconto	n.		discount
o dinheiro	n.		money
à direita			on/to the right
o edifício	n.		building
o elevador (-es)	n.		lift
encontrar-se (com)	v.		to meet, to meet up (with)
o engarrafamento	n.		traffic jam
a entrada	n.		entrance, way in
a escada rolante			escalator
escolher	v.		to choose
o escritório	n.		office
a esquadra de polícia			police station
à esquerda			on/to the left
a esquina	n.		(street) corner
o estádio	n.		stadium
a estátua	n.		statue
a estrada	n.		road
estreito	adj.		narrow
a farmácia	n.		chemist's (shop), pharmacy
fazer fila (para)			to queue (for), to queue up (for)
a fonte	n.		fountain
o freguês (-esa -eses, esas)	n.		customer
o hospital	n.		hospital
a igreja	n.		church
ir às compras			to go shopping
ir para casa			to go home
a joalharia	n.		jeweller's (shop), jewellery shop
largo	adj.		wide, broad
a liquidação (-ões)	n.		(clearance) sale
a livraria	n.		bookshop
o livro de cheques	n.		cheque book
a loja	n.		shop
a loja de brinquedos			toyshop
de má/baixa qualidade			(of) poor/low quality
o mapa	n.		map
o marco do correio			postbox, pillar box
o mercado	n.		market
a mercearia	n.		grocer's (shop)
a mesquita	n.		mosque
a moeda	n.		coin; currency
a montra	n.		(shop) window
o monumento	n.		monument
movimentado	adj.		busy; lively
o museu	n.		museum
o museu de arte	n.		(art) gallery
novo	adj.		new
novo em folha			brand new
a padaria	n.		baker's (shop), bakery
pagar	v.		to pay; to pay for
pagar com cheque			to pay by cheque
a papelaria	n.		stationer's (shop), stationery shop
o parque	n.		park
o parque de estacionamento	n.		car park
a passagem subterrânea			subway, underpass
o passeio	n.		pavement; walk; ride, drive
a pastelaria	n.		cake/pastry shop
o peão (-ões)	n.		pedestrian
a pechincha	n.		bargain, good buy
a peixaria	n.		fish shop, fishmonger's (shop)
perder-se	v.		to get lost, to lose one's way
os perdidos e achados			lost property
a piscina	n.		swimming pool
a placa de sinalização			road sign, signpost
a ponte	n.		bridge
o portão (-ões)	n.		gate
a praça	n.		(town) square; market
o preço	n.		price, cost
o presente	n.		present, gift
o primeiro andar			first floor
procurar	v.		to look for, to search for
em promoção			on (special) offer
provar	v.		to try (on)
o quartel dos bombeiros	n.		fire station
o quiosque	n.		kiosk, news(paper) stand
o recibo	n.		receipt
o reembolso	n.		refund, reimbursement
o rés-do-chão	n.	inv.	ground floor
o restaurante	n.		restaurant
a rua	n.		street
a saída	n.		exit, way out
a sapataria	n.		shoe shop
de segunda mão			second-hand
o semáforo	n.		(set of) traffic lights
a sinagoga	n.		synagogue
o supermercado	n.		supermarket
o talho	n.		butcher's (shop)
o teatro	n.		theatre
a torre	n.		tower
trocar	v.		to change, to exchange, to swap
o troco	n.		change
o túnel (-eis)	n.		tunnel
vender	v.		to sell


acampar	v.		to camp
o aeroporto	n.		airport
a África	n.		Africa
a África do Sul			South Africa
a aldeia	n.		village
a Alemanha	n.		Germany
alemão (-ã -ães -ãs)	adj.		German
a alfândega	n.		customs
a América do Norte			North America
a América do Sul			South America
americano	adj.		American
a Ásia	n.		Asia
aterrar	v.		to land, to touch down
a Austrália	n.		Australia
australiano	adj.		Australian
a Áustria	n.		Austria
austríaco	adj.		Austrian
o autocarro	n.		bus
a auto-estrada (-s)	n.		motorway
o avião (-ões)	n.		(aero)plane
a bagagem (-ns)	n.		luggage, baggage
o barco	n.		boat
belga	adj.		Belgian
a Bélgica	n.		Belgium
a bicicleta	n.		bicycle, bike
o bilhete	n.		ticket
o Brasil	n.		Brazil
brasileiro	adj.		Brazilian
britânico	adj.		British
bronzeado	adj.		(sun)tanned
bronzear-se	v.		to get a (sun)tan
o caminho de ferro			railway
o Canadá	n.		Canada
canadiano	adj.		Canadian
o carro	n.		car
chegar	v.		to arrive
a China	n.		China
chinês (-esa -eses, esas)	adj.		Chinese
a cidade	n.		city, town
o colete salva-vidas			life jacket
o comboio	n.		train
compreender	v.		to understand
descer do autocarro			to get off the bus
descolar	v.		to take off, to leave the ground
desfazer as malas			to unpack (one's bags)
a Dinamarca	n.		Denmark
dinamarquês (-esa -eses, esas)	adj.		Danish
a direcção (-ões)	n.		direction
egípcio	adj.		Egyptian
o Egipto	n.		Egypt
o eléctrico	n.		tram
entrar no autocarro			to get on the bus
o equador	n.		equator
escocês (-esa -eses, esas)	adj.		Scottish
a Escócia	n.		Scotland
a Espanha	n.		Spain
espanhol (-ola -óis -olas)	adj.		Spanish
a estação (-ões)	n.		station
os Estados Unidos			(the) United States
o este	n.		east
a estrada principal			main road
no estrangeiro			abroad
estrangeiro	adj.		foreign
a Europa	n.		Europe
europeu (-eia -eus -eias)	adj.		European
a excursão (-ões)	n.		excursion; walk, hike, ramble
exótico	adj.		exotic
falar português			to speak Portuguese
fazer as malas			to pack (one's bags)
fazer turismo			to go sight-seeing
as férias	n.		holidays
a França	n.		France
francês (-esa -eses, esas)	adj.		French
a fronteira	n.		border, frontier
a gasolina	n.		petrol
a Grécia	n.		Greece
grego	adj.		Greek
a Holanda	n.		Holland
holandês (-esa -eses, esas)	adj.		Dutch
o hotel	n.		hotel
húngaro	adj.		Hungarian
a Hungria	n.		Hungary
a Índia	n.		India
indiano	adj.		Indian
a Inglaterra	n.		England
inglês (-esa -eses, esas)	adj.		English
ir de férias			to go on holiday
a Irlanda	n.		Ireland
irlandês (-esa -eses, esas)	adj.		Irish
a Itália	n.		Italy
italiano	adj.		Italian
o Japão	n.		Japan
japonês (-esa -eses, esas)	adj.		Japanese
lento	adj.		slow
leve	adj.		light
a língua	n.		language; tongue
a mala	n.		suitcase
o mapa	n.		map
o Mar Báltico			Baltic Sea
o Mar Mediterrâneo			Mediterranean Sea
o Mar Negro			Black Sea
mexicano	adj.		Mexican
o México	n.		Mexico
a mochila	n.		rucksack, backpack
a moto	n.		motorcycle, motorbike
o mundo	n.		world
o navio	n.		ship
o norte	n.		north
a Noruega	n.		Norway
norueguês (-esa -eses, esas)	adj.		Norwegian
a Nova Zelândia			New Zealand
o Oceano Antárctico			Antarctic Ocean
o Oceano Árctico	n.		Arctic Ocean
o Oceano Atlântico			Atlantic Ocean
o Oceano Índico			Indian Ocean
o Oceano Pacífico			Pacific Ocean
o oeste	n.		west
o país	n.		country
o País de Gales			Wales
os Países Baixos			(the) Netherlands
a paragem de autocarro			bus stop
o parque de campismo			campsite
partir	v.		to leave, to depart
o passaporte	n.		passport
perder o autocarro			to miss the bus
pesado	adj.		heavy
polaco	adj.		Polish
o Pólo Norte			North Pole
o Pólo Sul			South Pole
a Polónia	n.		Poland
o porto	n.		port
o Portugal	n.		Portugal
português (-esa -eses, esas)	adj.		Portuguese
o postal (-ais)	n.		postcard
a pousada de juventude			youth hostel
a praia	n.		beach
o quarto	n.		room
rápido	adj.		fast, quick, rapid
a região (-ões)	n.		region; area
o Reino Unido			(the) United Kingdom
reservar um quarto			to reserve a room
a Rússia	n.		Russia
russo	adj.		Russian
a Suécia	n.		Sweden
sueco	adj.		Swedish
a Suíça	n.		Switzerland
suíço	adj.		Swiss
o sul	n.		south
o táxi	n.		taxi
a tenda	n.		tent
tropical (-ais)	adj.		tropical
turco	adj.		Turkish
o turismo	n.		tourism
a Turquia	n.		Turkey
a viagem (-ns)	n.		journey, trip, voyage
viajar	v.		to travel
o visto	n.		visa
